##############################
#      # #             #   # #
# # #   # ###########   #   # 
#  #   # # #         # ### # #
# ##  # # ### ##### # ##  # # 
# #  #  ##### # # # #  # ## # 
#      #     # #   # ## # ## #
# #  # ### ### ### # #  # ## #
#      ### #    ## # ###  ## #
### ###### #### #   #    # # #
#        # #    ## ## ###  # #
# # ##   # # ## #       ## # #
# # ### ## ##   #######  # # #
# #        ## ##      # ## # #
# #  ##### #  ##### #        #
# ## #   #      ## # # ## ## #
# #  # # # # ##    #   ## #  #
# #### # ######### #####  # ##
#      #           #      # ##
# # ######### # # ########   #
###         # # # #     #  # #
#  ##### ## # # # # ### #  # #
#      # #  # # # # # # # ####
## ### # #### # #     # #    #
#      #      # # ##### # # ##
## ############## #     # # ##
#                  ###### ## #
# ################## #  #  # #
#                         ## #
##############################
